elm,willow,poplar,hazel,alder,oak,beech,birch,mugwort,ragweed,plantain,sorrel,rye,grass,date
0,0,0,0,0,0,0,0,0,0,3,2,1,3,2021-06-24
0,0,0,0,0,0,0,0,0,0,3,2,1,3,2021-06-25
0,0,0,0,0,0,0,0,0,0,3,2,1,3,2021-06-26
0,0,0,0,0,0,0,0,0,0,3,2,1,3,2021-06-27
0,0,0,0,0,0,0,0,0,0,3,2,1,3,2021-06-28
0,0,0,0,0,0,0,0,0,0,3,2,1,3,2021-06-29
